        ---------------------------------------------------------
        |      |      |      |      |      |      |      |      |
      7 |  00  |  01  |  02  |  03  |  04  |  05  |  06  |  07  |
        |      |      |      |      |      |      |      |      |
        ---------------------------------------------------------
        |      |      |      |      |      |      |      |      |
      6 |  08  |  09  |  10  |  11  |  12  |  13  |  14  |  15  |
        |      |      |      |      |      |      |      |      |
        ---------------------------------------------------------
        |      |      |      |      |      |      |      |      |
      5 |  16  |  17  |  18  |  19  |  20  |  21  |  22  |  23  |
        |      |      |      |      |      |      |      |      |
        ---------------------------------------------------------
  R     |      |      |      |      |      |      |      |      |
  O   4 |  24  |  25  |  26  |  27  |  28  |  29  |  30  |  31  |
  W     |      |      |      |      |      |      |      |      |
  S     ---------------------------------------------------------
        |      |      |      |      |      |      |      |      |
      3 |  32  |  33  |  34  |  35  |  36  |  37  |  38  |  39  |
        |      |      |      |      |      |      |      |      |
        ---------------------------------------------------------
        |      |      |      |      |      |      |      |      |
      2 |  40  |  41  |  42  |  43  |  44  |  45  |  46  |  47  |
        |      |      |      |      |      |      |      |      |
        ---------------------------------------------------------
        |      |      |      |      |      |      |      |      |
      1 |  48  |  49  |  50  |  51  |  52  |  53  |  54  |  55  |
        |      |      |      |      |      |      |      |      |
        ---------------------------------------------------------
        |      |      |      |      |      |      |      |      |
      0 |  56  |  57  |  58  |  59  |  60  |  61  |  62  |  63  |
        |      |      |      |      |      |      |      |      |
        ---------------------------------------------------------
           0      1      2      3       4      5      6      7
           
                                 COLUMNS